"ID","Year","AMINOGLYCOSIDE","BETA-LACTAM","BLEOMYCIN","FOLATE-PATHWAY-INHIBITOR","FOSFOMYCIN","FOSMIDOMYCIN","LINCOSAMIDE","MACROLIDE","MULTIDRUG","NITROFURAN","PHENICOL","QUINOLONE","RIFAMYCIN","STREPTOGRAMIN","STREPTOTHRICIN","TETRACYCLINE","TRICLOSAN"
"AL36849PPY10005",2018,0,0,0,1,1,0,0,0,0,0,0,0,0,0,0,1,0
"AL36849PPY10073",2018,1,1,0,1,0,0,0,0,0,0,1,0,0,0,0,1,0
"AL36849PPY10190",2019,0,0,0,0,1,0,0,0,0,0,0,0,0,0,0,1,0
"AL36849PPY20067",2019,0,0,0,0,1,0,0,0,0,0,0,0,0,0,0,1,0
"AL36849PPY20112",2019,1,1,0,0,1,1,0,0,0,0,0,1,0,0,0,0,0
"AL36849PPY20161",2019,0,0,0,0,1,0,0,0,0,0,0,0,0,0,0,0,0
"AL36849PPY30116",2020,1,1,0,1,1,0,0,0,0,0,1,0,0,0,0,1,0
"AL36849PPY30154",2020,1,0,0,1,1,0,0,0,0,0,1,0,0,0,0,1,0
"AL36849PPY30178",2020,1,1,0,1,1,0,0,0,0,0,1,0,0,0,0,1,0
"AL36849PPY40039",2021,1,0,0,1,1,0,0,0,0,0,1,0,0,0,0,1,0
"AL36849PPY40077",2021,0,0,0,0,1,0,0,0,0,0,0,0,0,0,0,0,0
"AL36849PPY40103",2021,1,1,0,1,0,0,1,1,0,0,1,1,0,1,0,1,0
"AL36849PPY40119",2021,1,1,0,1,1,0,0,0,0,0,1,1,1,0,0,1,0
"AL36849PPY40157",2021,1,0,0,0,1,0,0,0,0,0,0,1,0,0,0,1,0
"AL36849PPY40174",2021,1,0,0,1,1,0,0,0,0,0,1,0,0,0,0,1,0
"AL36849PPY40189",2021,1,1,0,1,1,0,1,0,0,0,1,1,0,0,0,1,0
"CA95616PPY10001",2018,1,1,0,1,1,0,0,0,0,1,1,1,0,0,0,1,0
"CA95616PPY10094",2018,0,1,0,1,1,0,0,0,0,0,1,0,0,0,0,1,0
"CA95616PPY20004",2019,1,1,0,1,1,0,1,0,0,0,1,1,0,0,0,1,0
"CA95616PPY20114",2019,0,0,0,1,1,0,0,0,0,0,0,0,0,0,0,0,0
"CA95616PPY20145",2019,1,1,0,1,1,0,0,0,0,0,1,0,0,0,0,1,0
"CA95616PPY20175",2019,0,0,0,0,1,0,0,0,0,0,0,0,0,0,0,1,0
"CA95616PPY30046",2020,1,1,0,1,1,0,0,0,0,0,1,1,0,0,1,1,0
"CA95616PPY30094",2020,1,1,0,1,1,0,1,0,0,0,1,1,0,0,0,0,0
"CA95616PPY30140",2020,1,0,0,1,1,0,0,0,0,0,1,0,0,0,0,1,0
"CA95616PPY30211",2020,0,0,0,0,1,0,0,0,0,0,0,0,0,0,0,1,0
"CA95616PPY40013",2021,0,0,0,0,1,0,0,0,0,0,0,0,0,0,0,0,0
"CA95616PPY40091",2021,0,0,0,0,1,0,0,0,0,0,0,0,0,0,0,0,0
"CA95616PPY40176",2021,1,1,0,1,0,0,1,1,0,0,1,1,0,1,0,1,0
"CO80526PPY10122",2018,1,0,0,0,1,0,0,0,0,0,0,0,0,0,0,1,0
"CO80526PPY10133",2018,0,0,0,0,1,0,0,0,0,0,0,0,0,0,0,0,0
"CO80526PPY20021",2019,1,0,0,1,1,0,0,0,0,0,0,1,0,0,0,1,0
"CO80526PPY20178",2019,1,1,0,1,1,0,0,1,0,0,1,1,0,0,0,1,0
"CO80526PPY20275",2019,1,1,0,1,0,0,1,0,0,0,1,1,0,0,0,1,0
"CO80526PPY30293",2021,0,0,0,0,1,0,0,0,0,0,0,0,0,0,0,1,0
"CO80526PPY30304",2021,1,1,0,1,1,0,0,0,0,0,1,0,0,0,0,1,0
"CO80526PPY30312",2021,0,0,0,0,1,0,0,0,0,0,0,0,0,0,0,0,0
"CO80526PPY30339",2021,1,1,0,1,1,0,0,0,0,0,1,1,0,0,0,1,0
"CO80526PPY40114",2021,1,0,0,1,1,0,0,0,0,0,1,0,0,0,0,1,0
"CO80526PPY40117",2021,1,1,0,1,1,0,0,0,0,0,1,0,0,0,0,1,0
"CO80526PPY40142",2021,1,1,0,1,0,0,1,1,0,0,1,1,1,0,0,1,0
"CO80526PPY40172",2021,0,0,0,0,1,0,0,0,0,0,0,0,0,0,0,0,0
"CO80526PPY40229",2021,1,1,0,1,1,0,0,1,0,0,1,1,0,0,0,1,0
"CO80526PPY40230",2021,1,1,0,1,1,0,0,0,0,0,1,0,0,0,0,1,0
"FL34741PPY30070",2020,0,0,0,0,1,0,0,0,0,0,0,0,0,0,0,0,0
"FL34741PPY40001",2021,0,0,0,0,1,0,0,0,0,0,0,0,0,0,0,1,0
"GA30602PPY10161",2018,1,0,0,1,1,0,0,0,0,0,0,0,0,0,0,1,0
"GA30602PPY10163",2018,0,0,0,0,1,0,0,0,0,0,0,0,0,0,0,0,0
"GA30602PPY10164",2018,0,0,0,0,1,0,0,0,0,0,0,0,0,0,0,0,0
"GA30602PPY30381",2020,0,0,0,0,1,1,0,0,0,0,0,0,0,0,0,0,0
"GA30602PPY30382",2020,0,0,0,0,1,0,0,0,0,0,0,0,0,0,0,1,0
"GA30602PPY30383",2020,1,1,0,1,1,0,0,0,0,0,1,0,0,0,0,1,0
"GA30602PPY30388",2020,0,0,0,0,1,0,0,0,0,0,0,0,0,0,0,0,0
"GA30602PPY40381",2021,0,0,0,0,1,0,0,0,0,0,0,0,0,0,0,0,0
"GA30602PPY40382",2021,1,1,0,1,1,0,0,0,0,0,1,0,0,0,1,1,0
"GA30602PPY40384",2021,1,1,0,1,1,0,0,0,0,0,1,0,0,0,0,1,0
"IA50014PPY30009",2020,0,0,0,0,1,0,0,0,0,0,0,0,0,0,0,0,0
"IA50014PPY30036",2021,1,1,0,1,1,0,0,0,0,0,1,1,0,0,0,1,0
"IA50014PPY40001",2021,1,1,0,1,1,1,0,0,0,0,1,1,0,0,0,1,0
"IA50014PPY40016",2021,1,1,0,1,1,0,0,0,0,0,1,1,0,0,0,1,0
"IA50014PPY40019",2021,0,0,0,0,1,0,0,0,0,0,0,0,0,0,0,0,0
"IA50014PPY40025",2021,1,1,0,1,1,1,0,0,0,0,0,0,0,0,0,1,0
"IL61802PPY40028",2021,0,0,0,0,1,0,0,0,0,0,0,0,0,0,0,0,0
"IL61802PPY40069",2022,0,0,0,0,1,0,0,0,0,0,0,0,0,0,0,0,0
"IL61802PPY40130",2022,0,0,0,0,1,0,0,0,0,0,0,0,0,0,0,0,0
"IN47907PPY10239",2018,1,1,0,1,1,0,0,0,0,1,1,1,0,0,0,1,0
"IN47907PPY20383",2019,1,0,0,1,1,0,0,0,0,0,1,0,0,0,0,1,0
"IN47907PPY20445",2019,1,1,0,1,1,0,1,1,0,0,1,1,0,0,0,1,0
"IN47907PPY20582",2019,1,1,0,1,1,1,1,1,0,0,0,1,1,0,0,1,0
"IN47907PPY30032",2020,1,0,0,1,1,0,0,0,0,0,1,0,0,0,0,1,0
"IN47907PPY30075",2020,1,1,0,1,1,0,0,0,1,0,1,0,0,0,0,1,0
"IN47907PPY30109",2020,1,0,0,1,1,0,0,0,0,0,0,0,0,0,0,1,0
"IN47907PPY30162",2020,0,0,0,0,1,0,0,0,0,0,0,0,0,0,0,0,0
"IN47907PPY30192",2020,1,1,0,1,1,0,0,0,0,0,1,1,0,0,0,1,0
"IN47907PPY30240",2020,1,1,0,1,1,0,0,0,0,0,1,0,0,0,0,1,0
"IN47907PPY40089",2021,0,0,0,0,1,0,0,0,0,0,0,0,0,0,0,1,0
"IN47907PPY40109",2021,1,0,0,1,1,0,0,0,0,0,1,0,0,0,0,1,0
"IN47907PPY40173",2021,0,0,0,0,1,0,0,0,0,0,0,0,0,0,0,0,0
"IN47907PPY40214",2021,1,1,0,1,1,0,1,0,0,0,1,1,0,0,0,1,0
"KS66506PPY20083",2019,0,0,0,0,1,0,0,0,0,0,0,0,0,0,0,0,0
"KY40511PPY10001",2018,1,0,0,1,1,0,0,0,0,0,1,1,0,0,0,1,0
"KY40511PPY10114",2018,0,0,0,1,1,0,0,0,0,0,0,0,0,0,0,1,0
"KY40511PPY20020",2019,1,0,0,1,1,0,0,0,0,0,1,1,0,0,0,1,0
"KY40511PPY20117",2019,0,0,0,0,1,0,0,0,0,0,0,0,0,0,0,1,0
"KY40511PPY20152",2019,1,1,0,1,1,0,1,0,0,0,1,1,0,0,0,1,0
"KY40511PPY20172",2019,1,0,0,1,1,0,0,0,0,0,1,0,0,0,0,1,0
"KY40511PPY20308",2019,1,1,0,1,1,0,0,0,0,0,1,1,0,0,0,1,0
"KY40511PPY30037",2020,0,0,0,0,1,0,0,0,0,0,0,0,0,0,0,0,0
"KY40511PPY30046",2020,0,0,0,1,1,0,0,0,0,0,0,0,0,0,0,0,0
"KY40511PPY30098",2020,0,0,0,0,1,0,0,0,0,0,0,0,0,0,0,0,0
"KY40511PPY30167",2020,0,0,0,0,1,0,0,0,0,0,0,0,0,0,0,0,0
"KY40511PPY40021",2021,1,0,0,1,0,0,0,0,0,0,0,0,0,0,0,1,0
"KY40511PPY40056",2021,0,0,0,0,1,0,0,0,0,0,0,0,0,0,0,0,0
"KY40511PPY40172",2021,1,1,1,0,1,0,0,0,0,0,0,0,0,0,0,0,0
"KY40511PPY40208",2021,0,0,0,0,1,1,0,0,0,0,0,1,0,0,0,0,0
"KY42240PPY30001",2020,1,1,0,1,1,0,0,0,0,0,1,1,0,0,0,1,0
"KY42240PPY30004",2020,1,1,0,1,1,0,0,0,0,0,1,0,0,0,0,1,0
"KY42240PPY30062",2020,0,0,0,0,1,0,0,0,0,0,0,0,0,0,0,1,0
"KY42240PPY30163",2020,0,1,0,0,1,0,0,0,0,0,0,0,0,0,0,1,0
"KY42240PPY40023",2021,1,0,0,1,1,0,0,0,0,0,0,0,0,0,0,1,0
"KY42240PPY40085",2021,0,0,0,0,1,0,0,0,1,0,0,0,0,0,0,0,0
"KY42240PPY40099",2021,0,0,0,0,1,0,0,0,0,0,0,0,0,0,0,1,0
"KY42240PPY40116",2021,0,0,0,1,1,0,0,0,0,0,0,0,0,0,0,0,0
"KY42240PPY40134",2021,0,0,0,0,1,0,0,0,0,0,0,0,0,0,0,0,0
"KY42240PPY40151",2021,1,0,0,0,1,0,0,0,0,0,0,0,0,0,0,1,0
"KY42240PPY40176",2021,0,0,0,0,1,0,0,0,0,0,0,0,0,0,0,0,0
"LA70803PPY30002",2020,1,1,0,1,1,0,0,0,1,0,1,1,0,0,0,1,0
"LA70803PPY30052",2020,0,0,0,0,1,0,0,0,0,0,0,0,0,0,0,1,0
"MI48910PPY10006",2018,1,1,0,1,1,0,0,0,0,0,0,0,0,0,0,0,0
"MI48910PPY10017",2018,0,0,0,0,1,0,0,0,0,0,0,0,0,0,0,1,0
"MI48910PPY20002",2019,1,1,0,1,1,0,0,0,0,0,1,1,0,0,0,1,1
"MI48910PPY20051",2019,1,0,0,1,1,0,0,0,0,0,0,0,0,0,0,1,0
"MI48910PPY20138",2019,1,1,0,1,1,0,0,0,0,0,0,0,0,0,0,1,0
"MI48910PPY20174",2019,0,1,0,0,1,0,0,0,0,0,0,0,0,0,0,0,0
"MI48910PPY20218",2019,0,0,0,0,1,0,0,0,0,0,0,0,0,0,0,0,0
"MI48910PPY30005",2020,1,0,1,0,1,0,0,0,0,0,0,0,0,0,0,0,0
"MI48910PPY40085",2021,0,0,0,0,1,0,0,0,0,0,0,0,0,0,0,0,0
"MI48910PPY40119",2021,1,0,0,1,1,0,0,0,0,0,1,0,0,0,0,1,0
"MI48910PPY40122",2021,0,0,0,0,1,0,0,0,0,0,0,0,0,0,0,0,0
"MI48910PPY40137",2022,1,1,0,1,1,0,0,0,0,0,1,0,0,0,0,1,0
"MN55108PPY10004",2018,1,1,0,1,1,0,0,0,0,1,1,1,0,0,0,1,0
"MN55108PPY10220",2018,1,1,0,1,1,0,0,0,0,0,1,1,0,0,0,1,0
"MN55108PPY20049",2019,1,1,0,1,0,0,0,0,0,0,0,1,0,0,0,1,0
"MN55108PPY20053",2019,1,1,0,1,1,1,0,0,0,0,1,1,0,0,0,1,0
"MN55108PPY20063",2019,0,1,0,1,1,1,0,0,0,0,0,0,0,0,0,1,0
"MN55108PPY20082",2019,1,1,0,1,1,0,0,0,0,0,1,0,0,0,0,1,0
"MN55108PPY30051",2020,1,0,0,1,1,0,0,0,0,0,0,0,0,0,0,1,0
"MN55108PPY30052",2020,0,0,0,0,1,0,0,0,0,0,0,0,0,0,0,0,0
"MN55108PPY30061",2020,0,0,0,0,1,0,0,0,0,0,0,0,0,0,0,0,0
"MN55108PPY40053",2021,1,1,0,1,1,0,0,1,0,0,1,1,0,0,0,1,0
"MN55108PPY40057",2021,1,1,0,1,1,0,0,1,0,1,1,1,0,0,0,1,0
"MN55108PPY40081",2021,0,0,0,0,1,0,0,0,0,0,0,0,0,0,0,0,0
"MO65211PPY10016",2018,1,1,0,1,1,1,0,0,0,0,1,0,0,0,0,1,0
"MO65211PPY11006",2018,1,1,0,1,1,0,0,0,0,0,1,1,0,0,0,1,0
"MO65211PPY20101",2019,1,1,1,1,1,1,0,0,0,0,1,1,0,0,0,1,0
"MO65211PPY20119",2019,0,0,0,0,1,0,0,0,0,0,0,0,0,0,0,0,0
"MO65211PPY20135",2019,1,1,0,1,0,0,0,0,0,0,1,0,0,0,0,1,0
"MO65211PPY20142",2019,0,0,0,0,1,1,0,0,0,0,0,1,0,0,0,0,0
"MO65211PPY30101",2020,0,0,0,0,1,0,0,0,0,0,0,0,0,0,0,1,0
"MO65211PPY30108",2020,0,0,0,0,1,0,0,0,0,0,0,0,0,0,0,0,0
"MO65211PPY30119",2020,0,0,0,0,1,0,0,0,0,0,0,0,0,0,0,0,0
"MO65211PPY40101",2021,1,1,0,1,0,0,0,1,0,0,1,1,0,0,0,1,0
"MO65211PPY40102",2021,0,0,0,1,1,0,0,0,0,0,0,0,0,0,0,0,0
"MO65211PPY40103",2021,1,1,0,1,1,1,0,0,0,0,0,0,0,0,0,1,0
"MO65211PPY40104",2021,1,1,0,1,1,0,0,0,0,0,1,1,0,0,0,1,0
"MO65211PPY40105",2021,0,0,0,0,1,0,0,0,0,0,0,0,0,0,0,1,0
"MS39208PPY30036",2020,0,0,0,0,0,0,0,0,0,0,0,0,0,0,0,1,0
"MS39208PPY30175",2020,0,0,0,0,1,0,0,0,0,0,0,0,0,0,0,0,0
"MS39208PPY30193",2020,1,0,0,1,1,0,0,0,0,0,0,0,0,0,0,1,0
"MS39208PPY40030",2021,0,0,0,0,1,0,0,0,0,0,0,0,0,0,0,0,0
"MS39208PPY40154",2021,1,0,0,1,1,0,0,0,0,0,1,0,0,0,0,1,0
"MS39208PPY40186",2021,1,0,0,1,1,0,0,0,0,0,1,0,0,0,0,1,0
"MS39208PPY40292",2021,0,0,0,0,1,0,0,0,0,0,0,0,0,0,0,1,0
"NC27607PPY40026",2021,0,0,0,0,1,0,0,0,0,0,0,0,0,0,0,1,0
"ND58102PPY20027",2019,1,1,0,0,0,0,0,0,0,0,0,0,0,0,0,0,0
"ND58102PPY30045",2020,1,0,0,1,1,0,0,0,0,0,0,0,0,0,0,1,0
"ND58102PPY30175",2020,1,1,0,1,1,0,0,1,0,1,1,1,0,0,0,1,0
"ND58102PPY40045",2021,0,0,0,0,1,0,0,0,0,0,0,0,0,0,0,1,0
"ND58102PPY40102",2021,1,1,0,1,1,0,0,0,0,0,0,0,0,0,1,1,0
"NE68583PPY10013",2018,0,0,0,0,1,0,0,0,0,0,0,0,0,0,0,0,0
"NE68583PPY10061",2018,0,0,0,0,1,0,0,0,0,0,0,0,0,0,0,0,0
"NE68583PPY20009",2019,0,0,0,0,1,0,0,0,0,0,0,0,0,0,0,0,0
"NE68583PPY20056",2019,1,1,0,1,1,0,0,0,0,0,1,0,0,0,1,1,0
"NE68583PPY20165",2019,0,0,0,0,1,0,0,0,0,0,0,0,0,0,0,1,0
"NE68583PPY30015",2020,0,0,0,0,1,0,0,0,1,0,0,0,0,0,0,0,0
"NE68583PPY30070",2020,0,0,0,0,1,0,0,0,0,0,0,0,0,0,0,0,0
"NE68583PPY30273",2020,0,0,0,0,1,0,0,0,0,0,0,0,0,0,0,0,0
"NE68583PPY40001",2021,0,0,0,0,1,0,0,0,0,0,0,0,0,0,0,1,0
"NE68583PPY40134",2021,1,0,0,1,1,0,0,0,0,0,1,0,0,0,0,1,0
"NE68583PPY40158",2021,0,0,0,0,1,0,0,0,0,0,0,0,0,0,0,0,0
"NE68583PPY40250",2021,0,0,0,0,1,0,0,0,0,0,0,0,0,0,0,0,0
"NY14853PPY10001",2018,1,1,0,1,1,1,0,0,0,0,0,1,0,0,0,1,0
"NY14853PPY10293",2018,1,1,0,0,1,0,0,0,0,0,0,0,0,0,0,1,0
"NY14853PPY20226",2019,0,1,0,0,0,0,0,0,0,0,0,0,0,0,0,0,0
"NY14853PPY20319",2019,0,1,0,0,0,0,0,0,0,0,0,0,0,0,0,1,0
"NY14853PPY20427",2019,1,1,0,1,1,0,0,1,0,0,1,0,0,0,0,1,0
"NY14853PPY20433",2019,0,1,0,0,0,0,0,0,0,0,0,0,0,0,0,1,0
"NY14853PPY30265",2020,1,1,0,1,0,0,0,0,0,0,0,1,0,0,0,1,0
"NY14853PPY30287",2020,1,1,0,1,1,0,0,0,0,0,0,0,0,0,1,1,0
"NY14853PPY30356",2020,0,0,0,0,1,0,0,0,0,0,0,0,0,0,0,0,0
"NY14853PPY30365",2020,1,1,0,1,0,0,0,0,0,0,1,0,0,0,0,1,0
"OH43068PPY10066",2018,0,0,0,0,1,0,0,0,0,0,0,0,0,0,0,1,0
"OH43068PPY20014",2019,1,1,0,1,1,0,0,0,0,0,0,0,0,0,1,1,0
"OH43068PPY20015",2019,0,0,0,1,1,0,0,0,0,0,0,0,0,0,0,1,0
"OH43068PPY20018",2019,1,1,0,1,1,0,0,0,0,0,1,1,0,0,0,1,0
"OH43068PPY20088",2019,1,0,0,1,1,0,0,0,0,0,0,0,0,0,0,1,0
"OH43068PPY30002",2020,1,1,0,1,1,0,0,0,0,0,0,0,0,0,0,1,0
"OH43068PPY30003",2020,0,0,0,0,1,1,0,0,0,0,0,1,0,0,0,0,0
"OH43068PPY30025",2020,1,1,0,1,0,0,0,0,0,0,1,1,0,0,0,1,0
"OH43068PPY30044",2020,0,1,0,0,0,0,0,0,0,0,0,0,0,0,0,0,0
"OH43068PPY30045",2020,1,1,0,1,0,0,0,0,0,0,1,0,0,0,0,1,0
"OH43068PPY30062",2020,1,1,0,1,1,0,0,0,0,0,1,0,0,0,0,1,0
"OH43068PPY30064",2020,1,1,0,1,1,0,0,0,0,0,1,0,0,0,0,1,0
"OH43068PPY30065",2020,1,0,0,1,1,0,0,0,0,0,0,0,0,0,0,1,0
"OH43068PPY40002",2021,1,0,0,1,0,0,0,0,0,0,0,0,0,0,0,1,0
"OH43068PPY40005",2021,1,0,0,1,1,0,0,0,0,0,0,0,0,0,0,1,0
"OH43068PPY40032",2021,1,1,0,1,0,0,0,0,0,0,1,0,0,0,0,1,0
"OH43068PPY40037",2021,1,0,0,1,0,0,0,0,0,0,0,0,0,0,0,1,0
"PA16802PPY20004",2019,0,0,0,0,1,1,0,0,0,0,0,0,0,0,0,0,0
"PA16802PPY20022",2019,1,0,0,1,1,0,0,0,0,0,0,0,0,0,1,1,0
"PA16802PPY20028",2019,1,1,0,0,0,0,0,0,0,0,0,0,0,0,0,1,0
"PA16802PPY20050",2019,1,1,0,1,1,0,0,0,0,0,0,0,0,0,0,1,0
"PA16802PPY20054",2019,1,1,0,1,0,0,0,0,0,0,1,0,0,0,0,1,0
"PA16802PPY20065",2019,0,0,0,0,1,0,0,0,0,0,0,0,0,0,0,0,0
"PA16802PPY30044",2020,1,1,0,1,1,0,1,0,0,0,1,0,0,0,0,1,0
"PA16802PPY30045",2020,0,0,0,0,1,1,0,0,0,0,0,0,0,0,0,0,0
"PA16802PPY30075",2020,0,0,0,0,1,0,0,0,0,0,0,0,0,0,0,0,0
"PA16802PPY30077",2020,1,1,0,1,1,0,0,0,0,0,1,0,0,0,0,1,0
"PA16802PPY40068",2021,1,1,0,1,1,0,1,0,0,0,1,1,0,0,0,1,0
"PA17110PPY10001",2018,0,0,0,0,1,0,0,0,0,0,0,0,0,0,0,0,0
"PA17110PPY10024",2018,1,1,0,0,0,0,0,0,0,0,0,0,0,0,0,1,0
"PA17110PPY20001",2019,0,0,0,0,1,1,0,0,0,0,0,0,0,0,0,0,0
"PA17110PPY20004",2019,1,1,0,1,1,0,0,0,0,0,1,0,0,0,0,1,0
"PA17110PPY20005",2019,0,0,0,0,1,0,0,0,0,0,0,0,0,0,0,0,0
"PA17110PPY20016",2019,1,1,0,1,1,0,0,1,0,0,0,0,0,0,1,1,0
"PA17110PPY20023",2019,1,1,0,0,1,0,0,0,0,0,0,0,0,0,0,1,0
"PA17110PPY20034",2019,1,1,0,0,1,1,0,0,0,0,0,0,0,0,0,1,0
"PA17110PPY20044",2019,1,1,0,1,0,0,0,0,0,0,0,0,0,0,0,1,0
"PA17110PPY30002",2020,0,0,0,0,1,0,0,0,0,0,0,0,0,0,0,0,0
"PA17110PPY30003",2020,1,1,0,1,1,0,0,0,0,0,1,1,0,0,0,1,0
"PA17110PPY30011",2020,1,1,0,0,0,0,0,0,0,0,0,0,0,0,0,0,0
"PA17110PPY30016",2020,0,1,0,0,0,0,0,0,0,0,0,0,0,0,0,1,0
"PA17110PPY30017",2020,1,1,0,1,1,1,0,0,0,0,0,0,0,0,0,1,0
"PA17110PPY30021",2020,1,1,0,1,0,0,0,0,0,0,0,0,0,0,0,1,0
"PA17110PPY30027",2020,1,1,0,1,0,0,0,0,0,0,0,0,0,0,0,1,0
"PA17110PPY30033",2020,1,1,0,1,0,0,0,0,0,0,0,0,0,0,0,0,0
"PA17110PPY30034",2020,1,1,0,1,1,1,0,0,0,0,1,0,0,0,0,1,0
"PA17110PPY30038",2020,1,1,0,1,1,0,0,0,0,0,0,0,0,0,0,0,0
"PA17110PPY40013",2021,1,1,0,1,1,0,1,1,0,0,1,1,1,0,0,1,0
"PA17110PPY40015",2021,1,1,0,1,1,1,0,0,0,0,0,0,0,0,0,1,0
"PA17110PPY40016",2021,1,1,0,0,1,0,0,0,0,0,0,0,0,0,0,1,0
"PA17110PPY40024",2021,0,0,0,0,1,0,0,0,0,0,0,0,0,0,0,0,0
"SD57007PPY10042",2018,0,0,0,0,1,0,0,0,0,0,0,0,0,0,0,0,0
"SD57007PPY20066",2019,1,1,0,1,1,0,1,0,0,0,1,1,0,0,0,1,0
"SD57007PPY20067",2019,1,1,0,1,1,0,1,0,0,0,1,1,0,0,0,1,0
"SD57007PPY20084",2019,1,1,0,1,1,0,0,0,0,0,1,1,0,0,0,1,0
"SD57007PPY20086",2019,0,1,0,0,1,0,0,0,0,0,0,0,0,0,0,1,0
"SD57007PPY20097",2019,0,0,0,0,1,0,0,0,0,0,0,0,0,0,0,0,0
"SD57007PPY20100",2019,0,1,0,0,1,0,0,0,0,0,0,0,0,0,0,0,0
"SD57007PPY30066",2020,0,0,0,0,1,0,0,0,0,0,0,0,0,0,0,1,0
"SD57007PPY30067",2020,1,1,0,1,1,0,0,0,0,0,1,0,0,0,0,1,0
"SD57007PPY30068",2020,0,0,0,0,1,1,0,0,0,0,0,0,0,0,0,0,0
"SD57007PPY30070",2020,0,1,0,0,1,0,0,0,0,0,0,0,0,0,0,1,0
"SD57007PPY30073",2020,0,0,0,0,1,0,0,0,0,0,0,0,0,0,0,0,0
"SD57007PPY30079",2020,0,0,0,0,1,0,0,0,0,0,0,0,0,0,0,0,0
"SD57007PPY40066",2021,1,1,0,1,1,0,0,0,0,0,1,1,0,0,0,1,0
"SD57007PPY40067",2021,1,1,0,1,1,0,1,0,0,0,1,1,0,0,0,1,0
"SD57007PPY40069",2021,0,0,0,0,1,0,0,0,0,0,0,0,0,0,0,1,0
"TN37220PPY40021",2021,1,1,0,1,1,0,0,0,0,0,1,0,0,0,0,1,0
"TN37220PPY40030",2021,0,0,0,0,1,0,0,0,0,0,0,0,0,0,0,0,0
"TN37220PPY40053",2021,1,1,0,1,1,0,0,0,0,0,1,0,0,0,0,1,0
"TX77840PPY10779",2018,1,0,0,1,1,0,0,0,0,0,1,1,0,0,0,1,0
"TX77840PPY11064",2018,0,0,0,0,1,0,0,0,0,0,0,0,0,0,0,0,0
"TX77840PPY20010",2019,1,0,0,1,1,0,0,0,0,0,1,0,0,0,0,1,0
"TX77840PPY20050",2019,0,0,0,0,1,0,0,0,0,0,0,0,0,0,0,0,0
"TX77840PPY40164",2021,0,0,0,0,1,0,0,0,0,0,0,0,0,0,0,0,0
"TX77840PPY40230",2021,0,0,0,0,1,0,0,0,0,0,0,0,0,0,0,0,0
"TX77840PPY40241",2021,1,1,0,1,1,0,0,1,0,0,1,1,0,0,0,1,0
"TX77845PPY30121",2020,0,0,0,0,1,1,0,0,0,0,0,0,0,0,0,0,0
"WA99164PPY10060",2018,1,0,0,1,1,0,0,0,0,0,1,0,0,0,0,1,0
"WA99164PPY10094",2019,0,0,0,0,1,0,0,0,0,0,0,0,0,0,0,0,0
"WA99164PPY20241",2019,0,0,0,0,1,0,0,0,0,0,0,0,0,0,0,0,0
"WI53706PPY10001",2018,1,1,0,1,1,0,0,0,0,0,1,1,0,0,0,1,0
"WI53706PPY10162",2018,0,0,0,0,1,0,0,0,0,0,0,1,0,0,0,0,0
"WI53706PPY20016",2019,1,1,0,1,1,0,0,0,0,0,1,1,0,0,0,1,0
"WI53706PPY20021",2019,1,0,0,1,1,0,0,0,0,0,1,0,0,0,0,1,0
"WI53706PPY20054",2019,0,0,0,0,0,0,0,0,0,0,0,0,0,0,0,1,0
"WI53706PPY20137",2019,1,1,1,1,1,0,0,0,0,0,1,0,0,0,0,1,0
"WI53706PPY20167",2019,0,0,0,0,1,0,0,0,0,0,0,0,0,0,0,0,0
"WI53706PPY20178",2019,1,1,0,1,1,0,0,0,0,0,1,0,0,0,0,1,0
"WI53706PPY30002",2020,0,0,0,0,1,0,0,0,0,0,0,0,0,0,0,0,0
"WI53706PPY30021",2020,1,1,0,1,1,0,0,0,0,0,0,0,0,0,0,1,0
"WI53706PPY30074",2020,1,1,0,1,1,0,0,0,0,0,1,1,0,0,1,1,0
"WI53706PPY30075",2020,1,1,0,0,1,1,0,0,0,0,0,0,0,0,0,0,0
"WI53706PPY30205",2020,1,0,0,1,0,0,0,0,0,0,0,0,0,0,0,1,0
"WI53706PPY30257",2020,1,1,0,1,1,0,0,0,0,0,0,0,0,0,1,1,0
"WI53706PPY40003",2021,1,1,0,1,1,0,0,1,0,0,1,1,0,0,0,1,0
"WI53706PPY40060",2021,0,0,0,0,1,0,0,0,0,0,0,1,0,0,0,0,0
"WI53706PPY40086",2021,0,0,0,0,1,0,0,0,0,0,0,0,0,0,0,0,0
"WI53706PPY40239",2021,0,1,0,0,0,0,0,0,0,0,0,0,0,0,0,0,0
"WI53706PPY40272",2021,0,0,0,0,1,0,0,0,0,0,0,0,0,0,0,0,0
"WI53706PPY40290",2021,1,0,0,0,1,0,0,0,0,0,0,0,0,0,0,1,0
